                                                  .                                                 
                                         ...................                                        
                                    .............................                                   
                                 ...................*...............                                
                               .......................................                              
                             ...........................................                            
                           ...............................................                          
                         .................................*.................                        
                       ...............*.......................................                      
                      .........................................................                     
                    .........................*...................................                   
                   ...............................................................                  
                  .....................*...........................................                 
                 ..........................*........................................                
                ........................*..*...................*.....................               
               .......................................................................              
              ............................**...........................................             
             ......................................*....................................            
            .............................................................................           
           .............*.................................................................          
          .................................*...............................................         
          .......................................................*.........................         
         ...........*.......................*...............................................        
        ....................................*......................*.........................       
        ..................................................................*..................       
       .................**..............*..........................................*..........      
       .............*...........................*..........*......*...........................      
      ...........................*......*......................................................     
      .........................................................................................     
     ............................................*..............................................    
     ..........................................*................................................    
    .*..............................................*.......*...............................*....   
    .............................................................................................   
   ...................................................*...........................................  
   ..............................................................*................................  
   .................*.*...........................................................................  
  .........................................................*....................................... 
  ...............................................*...............*.*............................... 
  ............................................*...*.*..*.......*...........................*....... 
  ...*.......*.................................*.*..*.............................................. 
  ................................................................................................. 
 .............................................................................*.....................
 ........................................................................*..........................
 .....................................................................*.............................
 .............*..............................................*.....*................................
 ..............................................................*.........*..............*........*..
 ......................*...........................................*................................
 .......*......................................*....................................................
 ..............................................*.........................................*..........
 ................................................................*..................................
.................................*.........*......X.................................................
 ...........................*........*.......................*.....*....*.......*...................
 ................................................................................*..................
 ....................................*..............................................................
 ..................................*..................................*.............................
 ...........................*........*.......................................................*......
 ............................................................................*......................
 ................................................................*......*...........................
 .....................................*......................................*......................
 .....................*.........*...................................................................
  .........*...........................................................*.........................*. 
  ................................................................................................. 
  ................................................................................................. 
  ......*..............*........................................................................... 
  .........................................................................*....................... 
   ..............................*........*.......................................................  
   ............................................*..............*...................................  
   ............................*.....*...................*....*...................................  
    ...*..............................................*..........................................   
    .............................................................................................   
     .........................*.............................................................*...    
     ...................................*.......................................................    
      ...............................................................*.........................     
      .....................*.............*.....................................................     
       .......................................................................................      
       ...........................................*...........................................      
        .....................................................................................       
        .......................................*.............................................       
         ...................................................................................        
          ......................................................*..................*..*....         
          ....................*............*...............................................         
           .............................*..*..............................................          
            .............................................................................           
             ...........................................................................            
              .....................................................................*...             
               ..................*..............*.*...................................              
                ..................*..................................................               
                 .........*..........................*.*............................                
                  ..........................................*......................                 
                   ...............................................................                  
                    .............................................................                   
                      .........................................................                     
                       ............................*..........................                      
                         ...................................................                        
                           ...............................................                          
                             ...........................................                            
                               .......................................                              
                                 ...................................                                
                                    .............................                                   
                                         ...................                                        
